put = класть
let = позволять
set = помещать; ставить, установить
spread = распространять
read = читать
hit = ударить
fit = подходить по размеру, приспосабливать
shut = закрывать
cut = резать
cost = стоить
hurt = причинить боль
begin = начинать
sing = петь
spring = вскочить; возникнуть
drink = пить
fight = сражаться
find = находить
climb = карабкаться; взбираться
strike = ударить; бить; бастовать
light = зажигать; освещать
shoot = стрелять
stand = стоять
understand = понимать
hang = вешать; висеть
get = получать; становиться; добираться
win = выиграть; победить
stick = втыкать; укалывать; приклеивать
wind = заводить (механизм); трубить; извиваться
sit = сидеть
meet = встречать
lead = вести
feed = кормить
speed = ускорять; спешить; мчатся, проносится
hold = держать
can = мочь; уметь
tell = рассказывать
sell = торговать, продавать
shoe = обувать; подковывать
hear = слышать, услышать
may = мочь; иметь возможность
buy = купить
catch = ловить, хватать
lose = терять
think = думать
seek = искать
bring = приносить
teach = учить, обучать, преподавать
leave = оставить; уйти
feel = чувствовать
deal = иметь дело
mean = означать; иметь в виду
lean = опираться; прислоняться
dream = видеть сны; мечтать
keep = держать; хранить
sleep = спать
spend = тратить; проводить (время)
send = посылать, присылать, отправлять, отсылать
build = строить
have / has = иметь, обладать
say = сказать
make = делать; производить; заставлять
pay = платить
lay = класть
learn = изучать, учить; узнавать
burn = жечь
come = приходить
become = становиться, делаться, превращаться
run = бежать; течь
be = быть
go = идти
beat = бить
show = показывать
shape = придавать форму
prove = доказывать; оказаться
do / does = делать
give = дать
eat = есть
lie = лежать; лгать (правильный глагол)
write = писать
drive = водить машину
rise = подниматься, вставать
ride = ездить верхом
fly = летать
fall = падать
see = смотреть, видеть
draw = рисовать, чертить; тащить, тянуть, волочить
know = знать
grow = расти
throw = бросать, кидать
blow = дуть; цвести, расцветать
take = брать
mistake = ошибаться
shake = трясти
speak = говорить
forget = забывать
break = ломать; разбивать
wear = носить (одежду и т. п.)
bear = родить, нести; переносить; выносить
hide = прятать, скрывать
choose = выбирать